澳大利亚 修订 苯醚 甲环唑 、 甲霜灵 农兽 残 限量	__label__0
台湾 发布 预 包装 食品 原产 国 标签 管理 法规 草案	__label__1
国际 食品 法典 培训 研讨会 在 京 召开	__label__0
我国 向 世界贸易组织 成员国 通报 了 GB2757 - 201x 《 蒸馏 酒 及其 配制 酒 》 食品安全 国家标准 征求意见 稿	__label__0
欧盟 修订 有机 葡萄酒 实施 条例	__label__0
台湾 公布 2 , 4 - D 等 16 中 农药 的 最大 残留 限量	__label__1
卫生部 拟 撤销 2 , 4 - 二氯苯 氧 乙酸 等 38 种 食品 添加剂	__label__0
商务部 发布 《 关于 进一步 加强 酒类 流通 随附 单 管理工作 的 通知 》	__label__1
加拿大 拟 修订 葡萄酒 标识 法规	__label__0
欧洲 食品 安全局 认为 葡萄酒 中 的 酪蛋白 可 产生 不良 过敏反应	__label__0
台湾 发布 谷物 和 咖啡 中 赭 曲霉 毒素 A 限量 标准	__label__1
工信部 印发 “ 食品 企业 质量 安全 检测 技术 示范 中心 ” （ 第一批 ） 名单	__label__1
澳大利亚 拟 考虑 降低 葡萄酒 中 酒精 含量	__label__0
卫生部 公开 征求 2012 年 食品安全 国家标准 项目 计划	__label__0
印度 发布 食品安全 与 标准 条例 （ 2011 ） — — 食品 产品 标准 和 添加剂	__label__1
德国 对 食品 供应链 中 接触 材料 的 安全性 进行 风险 评估	__label__0
国家 质检 总局 发布 2010 年 12 月份 、 2011 年 1 月份 进境 不 合格 食品 通报	__label__1
加拿大 卫生部 修订 包括 丙硫菌 唑 在内 等 多种 农药 的 最大 残留 限量 标准	__label__0
两项 食品 工具 和 工业 设备 用 清洗剂 行业标准 获批 发布	__label__1
1 月 25 日 央视 每周 质量 报告 《 酒鬼 酒 锁定 塑化剂 肇事 三 元凶 ： 均 位于 包装 环节   》	__label__1
以色列 修订 饮用水 化学 处理剂 标准	__label__0
日本 将 于 4 月 1 日 实施 新 的 食品 中 放射性 铯 限量 标准	__label__1
欧盟 修订 乙基 多 杀菌 素 的 最大 残留 限量	__label__0
卫生部 批准 3 种 食品包装 材料 用 添加剂 新品种	__label__0
日本 发布 有机 植物 农业 标准 修正案 综述 草案	__label__0
澳大利亚 修订 食品 和 饲料 中农 兽药 残留 限量	__label__0
欧盟 通过 食品质量 标识 申请 审批 程序 提案 ， 鼓励 消费者 选择 具有 质量 标识 的 食品	__label__1
法国 新 环保 法案 要求 产品 贴 碳 标签	__label__1
加拿大 正式 将 多 氯化 萘 （ Polychlorinated   naphthalenes ， PCNs ） 列入 有毒 物质 清单	__label__1
卫生部 办公厅 发布 关于 征求 《 食品 中 指示 性 多氯联苯 含量 的 测定 》 等 8 项 食品安全 国家标准 （ 征求意见 稿 ） 意见 的 函	__label__0
ECHA 委员会 拒绝 限制 消费品 中 四种 邻苯二甲酸 盐 的 提案	__label__0
欧盟 拟 修订 联 苯肼 酯 在 多种 蔬果 中 的 最大 残留 限量	__label__0
加拿大 批准 羧甲基 纤维 钠 用于 葡萄酒 稳定剂	__label__0
澳大利亚 修订 葡萄酒 中 允许 使用 的 添加剂 清单	__label__0
法国 修改 某些 食品 制造 中 加工 辅助剂 使用	__label__0
从 台湾 进口 酒类 产品 中 首次 检出 塑化剂	__label__1
质检 总局 发布 7 、 8 月份 进境 不 合格 食品 、 化妆品 信息 通报	__label__1
美国 与 法国 达成 酒精 饮料 进出口 信息 交流 机制	__label__0
《 食品容器 橡胶垫 片 》 和 《 食品容器 橡胶 垫圈 》 两项 化工行业 标准 将 于 7 月 1 日 开始 实施	__label__1
阿根廷 修订 葡萄酒 产品 容器 上 的 标签 要求	__label__0
欧盟 拟 修订 酿酒 葡萄 中 灭菌 丹 的 最大 残留 限量	__label__0
英国 食品 安全局 从 谷物 食品 中 检出 真菌 毒素 （ 麦角 生物碱 ）	__label__1
美国 酒精 烟草 税收 管理局 拟 修订 葡萄酒 标签 中 有关 葡萄 采收 日期 的 规定	__label__0
欧盟 食品 安全局 将 对 阿斯巴甜 的 安全性 进行 全面 评估	__label__0
加拿大 卫生部 修订 丙环唑 等 农药 的 最大 残留 限量	__label__1
食 药监局 发布 保健食品 命名 规定 （ 修订稿 ） 、 保健食品 命名 指南 （ 征求意见 稿 ） 和 保健食品 新 功能 产品 申报 与 审评 指南 （ 征求意见 稿 ）	__label__0
韩国 拟 延长 “ 有机 食品 ” 标签 标识 在 相关 产品包装 上 的 有效期	__label__0
山东省 质监局 发布 2012 年 第二季度 生产 加工 环节 食品 产品 省 监督 检验 结果 公告 （ 2012 年 第 3 批 ）	__label__1
德国 研究 认为 焦糖 遇热 产生 的 5 - 羟 甲基 糠醛 无 安全 风险	__label__0
可口可乐 （ 中国 ） 发生 “ 余氯 门 ” 事件	__label__1
欧盟 采用 新 的 食品 添加剂 肯定 清单	__label__1
美国 FDA 出台 新 的 全球战略 以 确保 进口产品 的 安全 和 质量	__label__1
欧盟 制定 2012 - 2014 年间 各 成员国 统一 的 食品 中 农药 残留 限量 的 控制 计划	__label__0
加拿大 卫生部 修订 多种 农药 的 MRL 值	__label__0
焦糖 色素 中 的 4 - 甲基 咪唑 问题 持续 发酵	__label__0
英国 食品 标准局 就 花旗 松素 （ Taxifolin ） 作为 新型 食品 配料 征求意见	__label__0
美国 制定 精甲霜灵 （ Mefenoxam ） 在 多种 植物 中 的 残留 限量	__label__0
日本 对 食品 中 放射性物质 指标 展开 健康 影响 评估	__label__0
质检 总局 公布 2011 年 09 、 10 月 进境 不 合格 食品 、 化妆品 信息	__label__1
欧盟 拟 修订 4 种 阔叶 蔬菜 中嘧菌 环胺 的 最大 残留 限量	__label__0
山 葡萄酒 、 露酒 国家标准 正式 发布	__label__1
阿尔巴尼亚 发布 “ 有关 葡萄园 与 葡萄酒 ” 的 议会 法 草案	__label__1
韩国 将 建立 食品标签 、 广告 初步 审查 制度 ， 并 允许 食品 从业人员 取得 进口 报关 代理员 资格	__label__0
澳大利亚 提议 禁止 倍 硫 磷 应用 于 部分 蔬果	__label__0
葡萄酒 中 赭 曲霉 毒素 A 的 限量 值 拟定 为 2.0 ug / Kg	__label__1
加拿大 参议院 通过 食品安全 法案	__label__0
印度 发生 重大 假酒 案   死亡 人数 升至 171 人	__label__1
《 发酵 酒精 和 白酒 工业 水污染 物排放 标准 》 将 于 2012 年 1 月 1 日 开始 执行	__label__1
欧盟 修订 面向 消费者 的 食品 信息 法规	__label__0
美国 发布 近期 出台 的 食品标签 法规 的 统一 生效 执行 日期	__label__1
欧洲 食品 安全局 公布 两种 食品 接触 材料 的 意见	__label__0
国家 工商总局 发布 《 流通 环节 不 符合 食品安全 标准 食品 和 超过 保质期 食品 退市 和 销毁 管理 办法 （ 征求意见 稿 ） 》	__label__0
卫生部 批准 葡萄 皮红 等 18 种 食品 添加剂 扩大 使用 范围 、 使用量	__label__1
贵州 将 被 列为 国家 重金属 防治 重点 省	__label__0
阿尔巴尼亚 制定 葡萄园 及 葡萄酒 相关 规范	__label__0
英国 就 最新 麸质 标识 规定 发布 消费者 建议	__label__0
2011 年 5 月 起 实施 的 食品行业 相关 国家标准 汇总	__label__1
美国 批准 继续 使用 两种 处理 材料 和 一种 工艺 方法 用于 酒类 和 果汁 生产	__label__1
欧洲 食品 安全局 公布 对 氟 环唑 （ Epoxiconazole ） 在 多种 谷物 中 残留 限量 的 评估 报告	__label__0
加拿大政府 公布 食品 过敏源 标签 法规	__label__1
欧盟 拟 修改 几种 农产品 中氟虫 酰胺 （ flubendiamide ） 的 残留 限量	__label__0
日本 对 葡萄酒 实施 纳 他 霉素 的 监控 检查	__label__1
韩国 修订 禁用 化学品 清单	__label__0
日本 修订 三 氟 羧草醚 等 7 种农 兽药 的 最大 残留 限量	__label__0
缅甸 将 解除 对 啤酒 味精 等 食品 的 进口 限制	__label__0
多 国 限制 进口 日本 食品	__label__0
欧盟 将 二甲基 聚硅氧烷 作为 消泡剂 增补 至 食品 补充剂	__label__0
上海 质监局 发布 2012 年 酒类 质量 专项 监督 抽查 结果	__label__1
澳大利亚 拟 提高 甜叶菊 糖苷 （ steviol   glycosides ） 在 多种 饮料 中 的 使用 限量	__label__0
酒鬼 酒 公司 11 月 21 日 声明 全文	__label__1
欧盟 准许 DDA 碳酸盐 （ DDACarbonate ） 、 噻虫嗪 （ thiamethoxam ） 作为 生物农药 活性 成分	__label__0
ISO 发布 关于 辐照 食品安全 新 标准 ISO   14470 : 2011	__label__1
南非 拟 对 含有 双酚 A 的 婴儿 奶瓶 颁布 禁令	__label__1
吉尔吉斯斯坦 发布 食用酒精 、 伏特加 、 烈性酒 安全 技术 条例 草案	__label__1
质检 总局 受理 义聚永 高粱酒 等 产品 地理 标志 产品 保护 申请	__label__0
食品安全 专家 董金 狮 ： 白酒 塑化剂 超标 问题 由来已久	__label__1
陕西省 质监局 公布 2012 年 第三批 食品 及 食品 相关 产品 监督 抽查 结果	__label__1
欧盟 修订 EC110 / 2008 烈性酒 法规 中 部分 地理 标志 产品名称	__label__0
韩国 将 大幅提高 日本 进口 食品 放射性 铯 管理 标准	__label__0
加拿大 新 《 消费品 安全 法案 》 将 于 6 月 20 日 正式 生效	__label__1
质检 总局 公布 2011 年 11 月份 进境 不 合格 食品 、 化妆品 清单	__label__1
日本 于 2012 年 10 月 1 日起 对 大米 、 牛肉 放射性物质 使用 新 标准	__label__1
卫生部 卫生 监督 中心 召开 进口 无 食品安全 国家标准 食品 许可 培训 会议	__label__0
欧盟 拟 修订 关于 保存 葡萄酒 产品 货运 随附 文件 和 葡萄酒业 注册 的 法规	__label__0
越南 将 于 2011 年 7 月 1 日起 正式 施行 酒精 饮料 食品安全 技术 条例	__label__1
欧盟 修订 喹啉 黄 、 日落黄 和 胭脂红 三种 食用 色素 的 使用 及 限量 要求	__label__0
以色列 修订 饮用水 处理剂 次氯酸钠 中 砷 的 最高 残留 限量	__label__0
美国 制定 噻虫胺 （ Clothianidin ） 在 水稻种子 中 的 临时 残留 限量	__label__0
墨西哥 制定 由 龙舌兰 制成 的 酒精 饮料 规范	__label__0
春节 期间 各地 监管部门 抽检 酒精 饮料 出现 问题 情况 汇总	__label__1
质检 总局 发布 “ 关于 立即 组织 对 葡萄酒 产品 生产 企业 实施 监督 检查 的 通知 ”	__label__1
国务院办公厅 印发 “ 关于 2012 年 食品安全 重点 工作 安排 的 通知 ”	__label__0
马来西亚 发布 聚碳酸酯 婴儿 奶瓶 双酚 A 禁令	__label__1
欧盟 拟 增加 8 种 物质 到 REACH 授权 物质 清单	__label__0
法国 将 于 近期 发布 双酚 A 和 其他 具有 内分泌 扰乱 作用 产品 的 评估 报告	__label__0
欧盟 批准 两种 添加剂 用于 发酵 葡萄汁 基 饮料	__label__0
乌干达 发布 第三版 食品 添加剂 通用 标准	__label__1
加拿大 将 苏丹红 等 纳入 到 环境保护 法 有毒 物质 清单	__label__1
加拿大 修订 氯虫 酰胺 、 咯菌 腈 、 种菌 唑 和 噻虫 嗪 的 最大 残留 限量	__label__0
欧盟 成员国 食品安全 当局 推进 新 食品 信息 规则	__label__0
欧盟 更新 食品 添加剂 规范	__label__0
印度 发布 食品安全 与 标准 条例 （ 2011 ） — — 包装 与 标签	__label__1
欧盟 更新 食品 添加剂 法规 Regulation   ( EC )   No   1333 / 2008 ， 建立 食品 添加剂 、 酶制剂 、 香精香料 和 营养 补充剂 中 允许 使用 的 添加剂 联合 目录	__label__0
工信部 发布 《 浓缩 果蔬汁 （ 浆 ） 加工 行业 准入条件 》	__label__1
质检 总局 等 七 部门 开展 酒类 打假	__label__1
卫生部 对拟 批准 的 261 种 食品包装 材料 用 添加剂 征求意见	__label__0
湖南省 质监局 2012 年 第 1 批 食品质量 安全 监督 抽查 中 2 种 酒类 产品 不 合格	__label__1
质检 总局 关于 转发 啤酒 生产 企业 自 产 自用 二氧化碳 有关 问题 的 函	__label__0
欧盟 修改 含铝 食品 添加剂 使用 条件 和 标准	__label__0
美国 修订 了 杀虫剂 嘧菌 酯 ( Azoxystrobin ) 的 最大 残留 容许 限量	__label__0
欧盟 修订 多种 作物 及 动物 源性 产品 中 的 乙酰 甲胺磷 等 农药 的 最大 残留 限量	__label__0
美国 密西西比州 修订 有关 酒精 饮料 搭售 产品 的 包装 规则	__label__0
日本 修改 农药 醚 菌 酯 、 草胺 磷 以及 氰霜唑 在 食品 中 的 残留 标准	__label__0
工信部 印发 食品工业 企业 诚信 管理体系 委托 评价 机构 （ 第二批 ） 名单	__label__1
欧洲 食品 安全局 建议 修改 稻瘟灵 等 4 种 农药 的 残留 限量	__label__0
欧盟 拟 修订 葡萄酒 产品 地理 标识 和 原产地 名称 保护 法规 的 部分 条款	__label__0
美国 加州 65 法案 致癌物 清单 拟 新增 邻苯二甲酸 丁苄 酯	__label__0
台湾地区 发布 食品 标示 宣传 或 广告 词句 涉及 夸张 、 误导 和 宣称 疗效 的 认定 标准	__label__1
英国 食品 标准局 将 调查 食品 中 微生物 和 化学 污染物 情况	__label__0
欧盟 拟 对 番薯 、 山药 和 葡萄 的 咯菌 腈 现行 MRL 值 进行 修订	__label__0
食品工业 “ 十二五 ” 发展 规划 发布 ， 酿酒 工业 位列 重点 行业 之一	__label__1
国家 质检 总局 发布 《 出口 食品 生产 企业 备案 管理 规定 》 （ 总局 令 第 142 号 ）	__label__1
台产 塑化剂 流向 两岸 四地 ， 大陆 港澳 急查 相关 产品	__label__1
美国 研究 称 葡萄酒 与 啤酒 含 多种 过敏原 ， 可 导致 过敏反应 以及 哮喘	__label__0
国标 委 开展 《 限制 商品 过度 包装 要求 　 食品 和 化妆品 》 实施 情况 调查	__label__0
欧盟 发布 食品 添加剂 的 审批 补充规定	__label__1
英国 及 欧盟 将 延长 葡萄酒 产品 标签 上 标注 卵 白蛋白 、 牛奶 和 溶菌素 等 过敏原 物质 的 豁免 期	__label__0
山东 青岛 检验 检疫局 连续 检出 不 合格 食品 接触 产品	__label__1
卫生部 公开 征集 2013 年度 食品安全 国家标准 立项 建议	__label__0
GB / T   26760 - 2011 《 酱香型 白酒 》 国家标准 发布	__label__1
卫生部 印发 食品 标准 清理 工作 方案	__label__1
欧盟 更新 食品 添加剂 法规 Regulation   ( EC )   No   1333 / 2008 ， 建立 食品 添加剂 及其 使用 条件 统一 目录 （ Union   list   of   food   additives ）	__label__0
新加坡 9 月 3 日起 施行 食品 添加剂 和 食品 接触 材料 新 要求	__label__1
欧盟委员会 允许 在 欧盟 范围 内 使用 甜味剂 甜菊糖	__label__1
欧盟 新增 一种 烈性酒 分类 “ Absinth （ 苦艾 酒 ） ”	__label__0
古井 贡酒 被 爆 部分 低档 酒系 酒精 勾兑	__label__1
美国 酒精 与 烟草 税收 贸易 管理局 批准 蒸馏 柠檬油 、 柠檬油 、 亚洲 薄荷油 等 作为 变性酒精 的 变性剂 使用	__label__1
日本 厚生 劳动 省 明年 4 月 起 实施 食品 辐射 新 标准	__label__0
美国 加州 通过 含 咖啡因 酒精 饮料 禁令	__label__1
美国 FDA 对 含 咖啡因 酒精 饮料 产品 发出 警告	__label__1
意大利 一款 葡萄酒 在 香港 被 爆 发现 乙二醇	__label__1
国务院 发布 关于 加强 食品安全 工作 的 决定	__label__1
农业部 发布 《 食品 中 阿维菌素 等 64 种 农药 最大 残留 限量 》 国家标准 征求意见 稿	__label__0
​ 欧盟 拟 提高 苹果 中 农药 氟啶 胺 的 最大 残留 限量	__label__0
卫生部 发布 《 饮料 》 等 4 项 食品安全 国家标准 征求意见 稿	__label__0
ISO   发布 农业 食品安全 标准 ISO / TS   22002 - 3	__label__1
贵州省 发布 《 贵州省 行业 用水 定额 》 等 6 项 地方 标准	__label__1
欧盟 修订 食品 中多环 芳烃 限量 法规	__label__0
欧盟 就 拟 茎 点霉属 毒素 对 人体 健康 构成 的 风险 发布 科学 意见	__label__0
英国 就 低 聚异 麦芽糖 醇 作为 新型 食品 配料 征求意见	__label__0
美国 缅因州 拟将 双酚 A 作为 优先 管控 的 化学物质 和 儿童用品 中 的 优先 管控 对象	__label__0
卫生部 针对 “ 葡萄酒 标签 中 二氧化硫 标识 和 进口 食品 原产 国 或 地区 名称 标识 ”   等 问题 发布公告	__label__0
新西兰 公布 2010 年 食品 农化 物 最大 残留 限量 修改 提案	__label__1
哥伦比亚 再次 延长 酒精 饮料 技术 法规 草案 评议 期	__label__0
欧盟 批准 颁布 关于 食品 添加剂 的 新 法令	__label__1
欧盟 将 全面 限制 含双酚 A 食品 接触性 塑料 材料 的 生产 和 销售	__label__0
欧盟 食品 接触 材料 新规 今年 5 月 1 日 开始 生效	__label__1
卫生部 就 《 食品 安全性 毒理学 评价 程序 》 等 16 项 食品安全 国家标准 征求 草案 意见	__label__0
台湾 修订 己二烯 酸 钙 等 食品 添加剂 的 使用 范围 及 限量 等 标准	__label__0
欧盟 拟 修订 密灭 汀 在 梨果 、 草莓 、 啤酒花 中 的 最大 残留 限量	__label__0
世界卫生组织 提出 降低 酗酒 风险 的 六条 建议	__label__0
加拿大 宣布 消费品 安全法 正式 生效	__label__1
台湾 进一步 限制 塑料 盘子 和 塑料 包装盒 的 使用量	__label__0
新西兰 食品 安全局 提醒 酒类 进口商 注意 标签 问题	__label__0
食品安全 国家标准 《 蒸馏 酒 及其 配制 酒 》 、 《 发酵酒 及其 配制 酒 》 正式 公布	__label__1
加拿大 加强 对 4 种 有毒 物质 的 管理	__label__0
美国 拟 修订 抗倒 酯 （ Trinexapac - ethyl ） 农兽 残 限量 标准 中 数种 农作物 的 分类 名称	__label__0
功能性 食品 和 饮料 出口 加拿大 须 关注 标签 新规	__label__0
近期 美国 农药 残留 限量 修订 情况	__label__0
新加坡 发布 酒精 饮料 标签 要求	__label__1
欧洲 食品 安全局 发布 报告 称四 溴 双酚 A 无 安全 风险	__label__0
阿根廷 建立 进口 葡萄酒 相关 产品 的 程序 要求	__label__1
欧盟 发布 食品标签 新 禁令	__label__1
日本 拟 批准 异 喹啉 和 吡咯 作为 食品 添加剂 使用	__label__1
欧盟 理事会 就 新 食品标签 法规 达成 了 一致意见	__label__0
欧盟 就 转基因 作物 以及 转基因 食品 与 饲料 的 许可 申请 发布 指导 文件	__label__1
国务院办公厅 关于 印发 2011 年 食品安全 重点 工作 安排 的 通知	__label__0
澳大利亚 酒精 饮料 生产 企业 将 在 产品 标签 上 自愿 标注 健康 警告 信息	__label__0
卫生部 印发 2012 年 食品安全 国家标准 项目 计划	__label__1
工信部 批准 制酒 饮料机械 码箱 垛机 等 标准	__label__0
质检 总局 发布 《 关于 注销 北京 真露 饮料 有限公司 等 261 家 企业 的 273 张 食品 生产 许可证 的 公告 》 （ 2011 年 第 57 号 公告 ）	__label__1
日本 修订 食品 、 添加剂 等 规格 标准 相关 条款	__label__0
美国 修订 联邦 法规 “ 国家 有机 计划 ” 中 关于 色素 的 条款	__label__0
日本 修订 “ 指定 添加物 名单 ”	__label__0
日本 福岛 大米 接连 检出 辐射 超标   安全性 受 质疑	__label__1
质检 总局 发布 “ 关于 冬虫夏草 不得 作为 普通 食品 原料 的 通知 ”	__label__1
我国 食品 农产品 出口 欧盟 应 严控 黄曲霉 毒素	__label__0
巴西 发布 非 发酵 酒精 饮料 中 准许 使用 的 食品 添加剂 名单	__label__1
南非 修订 啤酒大麦 相关 法规	__label__0
卫生部 公布 聚己 二酰丁 二胺 等 107 种 可 用于 食品包装 材料 的 树脂 名单	__label__1
加拿大 修订 吡唑 醚 菌 酯 和 啶 虫 脒 的 残留 限量 标准	__label__0
韩国 将 禁止 含双酚 A 的 婴幼儿 奶瓶	__label__1
美国 对 蒸馏 酒厂 条例 进行 全面 修订	__label__0
环保 标准 “ HL   617 - 2011 《 企业 环境 报告书 编制 导则 》 ” 10 月 1 日 开始 实施	__label__1
英国 食品 安全局 发布 食品包装 日期 标注 指南 文件	__label__1
国内 有关 食品 中 塑化剂 污染 的 最新 报道	__label__1
欧盟 修订 加香 葡萄酒 条例	__label__0
加拿大 正式 批准 甜叶菊 糖苷 作为 食品 用 甜味剂	__label__0
欧盟 修订 灭菌 丹 （ folpet ） 在 酿酒 葡萄 、 大蒜 、 番茄 中 的 残留 限量	__label__0
美国 制定 唑 嘧磺隆 （ Imazosulfuron ） 在 辣椒 、 大米 和 西红柿 中 的 残留 限量	__label__0
波兰 拟 修改 售酒 法令 限制 售酒 范围	__label__0
巴西 将 修改 葡萄酒 生产 规范	__label__0
欧盟 就 富含 铬 的 酵母 作为 膳食 补充剂 发布 意见	__label__0
卫生部 办公厅 公布 关于 《 食品 添加剂 使用 标准 》 （ GB2760 - 2011 ） 有关 问题 的 复函	__label__0
国家 食品安全 风险 评估 中心 发布 “ 食品 用 包装 用纸 适用 标准 有关 情况 的 说明 ”	__label__0
商务部 就 《 酒类 流通 管理 办法 （ 修订 ） （ 征求意见 稿 ） 》 公开 征求意见	__label__0
欧盟 将 与 中国 签订 打击 假冒 行为 的 协议	__label__0
加拿大 卫生部 修订 啶 酰菌胺 等 4 种 物质 的 最大 残留 限量 标准	__label__0
韩国 食品药品 管理局 拟定 修改 进口 健康 功能 食品 检验 方针	__label__0
卫生部 关于 印发 《 食品 相关 产品 新品种 行政许可 管理 规定 》 的 通知	__label__1
卫生部 拟 批准 人参 （ 人工 种植 ） 为 新 资源 食品	__label__0
加拿大 拟 允许 二 碳酸 二甲酯 （ Dimethyl   dicarbonate ） 作为 防腐剂 用于 葡萄酒 和 非标 水性 软饮料	__label__0
卫生部 发布 关于 “ 指定 食品 添加剂 产品 标准 的 有关 要求 的 公告 ”	__label__1
法国 国内 爆出 葡萄酒 造假 丑闻   假酒 或 已 流向 多个 国家	__label__1
《 食品安全 国家标准   食品 添加剂   焦 糖色 》 发布 征求意见 稿	__label__0
澳新 食品 标准局 发布公告 批准 2 类 转基因 食品	__label__1
欧盟 通过 新 的 食品 标识 规定 ， 要求 在 食品 配料 中 明确 标出 纳米材料	__label__1
山东省 发布 《 山东省 葡萄酒 、 白酒 、 啤酒 工业 “ 十二五 ” 发展 规划 》	__label__1
国家 质检 总局 公布 2011 年 2 月 进境 不 合格 食品 信息	__label__1
质检 总局 公布 2012 年 24 类 产品质量 国家 监督 抽查 结果	__label__1
以色列 发布 民用 饮水 处理 系统 - 过滤 和 净化 标准	__label__1
日本 拟 修改 食品 卫生法 实施 条例 及 食品 和 食品 添加剂 标准规范	__label__0
美国 FDA 建议 修订 食品标签 规例 以 认可 某些 健康 声明	__label__0
质检 总局 证实 伊利 部分 婴幼儿 乳粉 汞 含量 异常	__label__1
欧盟 建议 修改 杀菌剂 吡唑 醚 菌 酯 的 最大 残留 限量 标准	__label__0
英国 食品 安全局 公布 食品 与 环境 中 的 放射 物 报告	__label__0
国家 质检 总局 公布 2011 年 4 月 进境 不 合格 食品 、 化妆品 信息	__label__1
日本 对 食品 卫生法 实施 规则 进行 部分 修改	__label__0
第一届 食品安全 国家标准 审评 委员会 第四次 主任 会议 召开	__label__0
美国 制定 瓶装 饮用水 中 DEHP 的 限量 指标	__label__0
欧盟 拟 修订 溴苯 腈 （ bromoxynil ） 、 氯 吡 脲 （ forchlorfenuron ） 、 噻吩 磺隆 （ Thifensulfuron - Methyl ） 3 种 农药 的 最大 残留 限量	__label__0
台湾 修订 农药 最大 残留 限量 标准	__label__0
澳新 食品 标准局 发布 内源性 蛋白酶 加工 助剂 的 评估 报告	__label__0
澳大利亚 农药 和 兽药 局 建议 修改 澳新 食品 法典 标准 1.4 . 2 中 关于 MRL 值 的 部分 内容	__label__0
香港 宣布 将 塑化剂 纳入 食品 常规 检验 项目	__label__1
加拿大 拟将 7 种 意大利 葡萄酒 纳入 本国 商标法 的 地理 标志 保护 产品目录	__label__0
巴拉圭 将 正式 实行 食品 接触性 材料 强制 登记 程序	__label__1
环保部 发布 《 酿造 工业废水 治理 工程 技术规范 》 等 6 项 国家 环境保护 标准	__label__1
澳大利亚 调整 农残 限量 管理机构	__label__0
《 白酒 风味 物质 阈值 品评 指南 》 国家标准 开始 征求意见	__label__0
欧盟 食品 安全局 发布 关于 食品 中 烃类 矿物油 的 科学 意见	__label__0
欧盟 修订 关于 婴儿 塑料 奶瓶 限制 使用 双酚 A 的 法规	__label__0
贵州省 质检局 发布 “ 关于 征集 2011 年 — 2015 年 贵州省 重点 推进 标准化 计划 项目 的 通知 ”	__label__0
澳新 食品 立法 与 管理 论坛 12 月 9 日 在 墨尔本 召开	__label__0
山西汾酒 首度 回应 召回 事件 ： 酒中 活性炭 无害	__label__1
国家 粮食局 发布 《 粮油 储藏 技术规范 （ 修订 ） 》 征求意见 稿	__label__0
日本 拟 修订 农药 吲熟 酯 （ Ethychlozate ） 等 和 兽药 克拉 维酸 （ Clavulanic   acid ） 等 的 最大 残留 限量	__label__0
农业部 发布 《 食品 中 2 , 4 - 滴 等 195 种 农药 最大 残留 限量 （ 征求意见 稿 ） 》 和 《 豁免 制定 最大 农药 残留 限量 标准 的 农药 名单 （ 征求意见 稿 ） 》	__label__0
公安部 破获 一起 团伙 生产 销售 食用 地沟油 案件	__label__1
广东省 工商局 发布 2012 年 一季度 酒类 、 大米 等 食品 抽检 情况通报	__label__1
英国 食品 标准局 要求 食品 企业 评价 欧盟委员会 关于 降低 食品 、 饮料 中 喹啉 黄 、 日落黄 、 胭脂红 4R 等 着色剂 的 建议	__label__0
卫生部 疾控中心 营养 与 食品安全 所 就 部分 企业 申请 橡木 制品 作为 加工 助剂 使用 公开 征求意见	__label__0
质检 总局 发布 关于 食用酒精 产品 生产 许可 有关 事项 的 通知	__label__1
FDA 发布 酸化 及 发酵 食品 指南 草案	__label__1
卫生部 办公厅 关于 征求 《 食品 中 丙酸 钠 、 丙酸 钙 的 测定 》 等 9 项 食品安全 国家标准 （ 征求意见 稿 ） 意见 的 函	__label__0
日本 对 多种 农作物 中 农药 残留 的 MRL 值 进行 了 修订	__label__0
国务院办公厅 发布 “ 关于 严厉打击 食品 非法 添加 行为 切实加强 食品 添加剂 监管 的 通知 ”	__label__1
美国 FDA 针对 “ 无 麸质 ” 食品标签 标示 的 修订 评估 报告 征求意见	__label__0
危地马拉 发布 关于 酒精 饮料 、 蒸馏 酒精 饮料 标签 要求 的 中美洲 共同 技术 法规	__label__1
中国 酒业 协会 发布 “ 关于 贯彻落实 国务院 关于 集中 清理 整顿 滥用 中央 、 国家机关 “ 特供 ” “ 专供 ” 等 标识 问题 的 文件精神   加强 行业 自律 的 通知 ”	__label__1
美国农业部 颁布 国家 有机 计划 （ NOP ） 关于 继续 豁免 维生素 和 矿物质 的 临时 法令	__label__1
工信部 发布 2012 年 第三批 行业标准 制 修订 计划	__label__0
欧盟 修改 葡萄酒 运送 随附 文件 规定	__label__0
加拿大 拟 制定 联 苯肼 酯 ( Bifenazate ) 在 啤酒花 中 的 残留 限量	__label__0
欧盟 提议 加强 对 食品 接触 陶瓷 的 要求	__label__0
俄罗斯 或 修订 酒精 饮料 生产 销售 的 国家 调控 法规	__label__0
卫生部 将 塑化剂 邻苯二甲酸 酯类 物质 列入 黑名单	__label__1
中国台湾 修订 阿巴 汀 等 种 农药 在 不同 作物 中 的 农残 限量 标准	__label__0
欧盟 葡萄酒 行业 将 正式 启用 新 的 有机 食品标签	__label__0
30 个 香精香料 食品安全 国家标准 网上 征求意见	__label__0
江苏 、 河南 发布 啤酒大麦 、 啤酒 工业 水污染 物排放 标准 等 数项 地方 标准	__label__1
台湾 修订 食品 器具 容器 包装 卫生标准	__label__0
肯尼亚 发布 酒精 饮料 管制 法规 通告	__label__1
GB / T   18356 - 2007 《 地理 标志 产品   贵州 茅台酒 》 第 1 号 修改 单 正式 发布	__label__1
美国 修订 对 农药 呋虫胺 的 残留 限量 要求 和 对 杀 真菌 剂 多 氧 霉素 D 锌盐 的 残留 限量 豁免 条件 要求	__label__0
美国 《 食品安全 现代化 法案 》 正式 成为 法律	__label__1
欧盟 发布 新 的 食品 添加剂 申请 指南 文件	__label__1
欧盟 批准 EDTA 铁钠 作为 铁 强化剂	__label__0
台澎金马 单独 关税区 通过 了 食品 内 杀虫剂 残留 限量 标准	__label__0
质检 总局 发布 3 月份 进口 食品 、 化妆品 不 合格 信息	__label__1
欧盟 就 监控 食品 中 二恶英 与 多氯联苯 的 含量 制定 取样 及 分析方法	__label__0
农业部 发布 征求 《 农产品 及 食品 中 农药 最大 残留 限量 》 标准 意见 的 函	__label__0
全国 白酒 标准化 技术 委员会 老白干 香型 白酒 分 技术 委员会 成立 大会 在 石家庄 召开	__label__0
中国台湾 发布 真空包装 食品 验证 管 理 办法 草案	__label__1
欧盟 REACH 法规 新增 苯 汞 化合物 的 限制	__label__0
欧盟 拟 建立 授权 使用 食品 添加剂 的 统一 目录	__label__0
21 世纪 网 报道 《 致命 危机 ： 酒鬼 酒 塑化剂 超标 260% 》	__label__1
关于 回复 “ 卫生部 卫生 监督 中心 关于 征求 龙舌兰 酒 作为 进口 无 食品安全 国家标准 食品 有关 意见 的 函 ”	__label__0
日本 发现 福岛 稻米 辐射 水平 高 ， 需 全面 检测	__label__1
欧盟 食品 安全局 （ EFSA ） 将 启动 食品 接触 材料 双酚 A 再 评估 计划	__label__0
台湾 正式 通过 食品 器具 、 容器 、 包装 卫生标准 第四条 修正 条文	__label__0
牙买加 修订 啤酒 产品 标准	__label__0
美国 FDA 公布 食品安全 现代化 法 框架 下 的 新 法规	__label__1
酿酒 大曲 通用 分析方法 等 四项 行业标准 将 于 7 月 1 日 开始 实施	__label__1
赞比亚 将 延期 执行 货物 进口 检验 计划	__label__1
欧盟 拟 修订 杀菌剂 恶唑菌 酮 和 杀虫剂 氯虫 苯 甲酰 的 最大 残留 限量 标准	__label__0
欧盟 收到 多种 农作物 中环 氟菌胺 MRL 值 的 修订 建议	__label__0
台湾 修订 饮料 中锡 限量 和 微生物 限量 标准	__label__0
欧盟 食品标签 营养 声明 将成 强制 规定	__label__0
国家 食品 药品监督管理局 办公室 关于 发布 保健食品 中 可能 非法 添加 的 物质 名单 （ 第一批 ） 的 通知	__label__1
关于 贯彻落实 国务院 食安办 “ 进一步 加强 酒类 质量 安全 工作 ” 文件精神   加强 行业 自律 的 通知	__label__0
泰国 修订 食品 添加剂 标签 标注 要求	__label__0
阿根廷 制定 葡萄酒 中二 葡 糖苷 锦葵 色素 限量	__label__0
欧盟 欲 修订 食品 接触 材料 中 的 镉 和 铅	__label__0
美国 环境保护局 公布 了 苯醚 甲环唑 的 耐药性 报告	__label__1
卫生部 发布 关于 规范 食品 添加剂 新品种 许可 管理 的 公告	__label__1
台湾地区 拟 修订 食品 中 2 , 4 - 二氯苯 氧基 乙酸 等 32 种 杀虫剂 的 残留 限量	__label__0
美国 拟 允许 十二 烷基苯 磺酸钠 盐 用于 果蔬 清洗	__label__0
澳新 食品 标准局 发布 对 高 甜度 甜味剂 Advantame 的 第二轮 评估 报告	__label__0
卫生部 公开 征集 2011 年度 食品安全 国家标准 立项 建议	__label__0
南非 出台 食品 标识 新规	__label__1
欧盟 食品 安全局 公布 欧洲 各类 人群 的 铅 膳食 暴露 情况	__label__0
欧盟 将 出台 有机 葡萄酒 法规	__label__0
印度 出台 最新 食品安全 法案 ， 加强 管理 ， 提升 行业标准	__label__1
欧盟委员会 批准 溶菌酶 用于 啤酒	__label__0
质检 总局 公布 食品 添加剂 标准 目录	__label__1
台湾地区 “ 散装 食品 标示 相关 规定 ”   9 月 12 日起 生效	__label__1
加拿大 修订 三唑 并 嘧啶 类 杀菌剂 的 最大 残留 限量	__label__0
欧盟 将 从 2011 年 开始 实施 进出口 商品 电子 申报 制度	__label__0
欧盟 就 控制 发酵 食品 中 生物 胺 的 形成 发布 了 科学 意见	__label__0
印度 起草 新 酒精 限量 标准 遇阻	__label__0
卫生部 发布 《 预 包装 食品 营养 标签 通则 》 （ GB   28050 - 2011 ） 问答	__label__1
保 乐利 加 集团 发布 《 2012 中国 青年 群体 饮酒 行为 调研 报告 》	__label__0
英国 公布 2010 年 《 食品 与 环境 辐射 报告 》	__label__1
欧盟 通过 “ 禁止 果汁 中 添加 糖类 成分 ” 新 规定	__label__0
澳新 食品 标准局 发布 关于 扩大 食品 添加剂 羧甲基 纤维素 钠 用于 葡萄酒 澄清 剂 的 评估 意见	__label__0
台湾地区 修订 农药 残留 限量 标准 和 农产品 分类 表	__label__0
工信 部拟 制定 《 钢制 发酵 容器 技术 条件 》 行业标准	__label__0
英国 食品 安全局 对 某 公司 的 葡萄酒 发布 过敏 警告	__label__1
卫生部 关于 预 包装 饮料 酒 生产日期 标注 问题 的 复函	__label__0
英国 研究 称 双酚 A 所 造成 的 影响 会 延续 四代	__label__0
台湾地区 “ 有 容器 或 包装 的 食品 原产地 标示 相关 规定 ”   9 月 20 日起 生效	__label__1
加拿大 修订 环境保护 法案 中 出口 管制 化学物质 目录	__label__0
日本 福岛 县 郡 山市 大米 被 检出 辐射 值 严重 超标	__label__1
科威特 发布 海湾地区 （ GSO ） 标准 “ 预 包装 食品 工业生产 用 投入品 的 标签 要求 ”	__label__1
俄罗斯 发布 酒类 产品安全 技术 条例 草案	__label__1
澳新 食品 标准局 拟 讨论 允许 食品 加工 助剂 二甲醚 （ dimethyl   ether ） 用于 食品 生产	__label__0
美国 塑料工业 协会 发布 食品 塑料包装 供应链 良好 生产 规范 指南	__label__1
印尼 加工 食品 中 微生物 和 化学 污染物 的 最大 限量 法规 通报	__label__1
卫生部 发布 食品安全 国家标准 “ 十二五 ” 规划 征求意见 稿	__label__0
欧盟 食品 安全局 就 3 种 共聚物 用于 食品 接触 材料 的 安全性 发布 科学 意见	__label__0
美国 缅因州 宣布 全面禁止 双酚 A 用于 婴幼儿 食品 包装容器	__label__1
质检 机构 的 相关 观点	__label__1
欧盟 修订 大麦 、 玉米 和 小麦 等 植物 中苯霜灵 等 多种 农药 的 最大 残留 限量	__label__0
韩国 多种 拉面 被 检出 含有 致癌物 “ 苯并芘 ”	__label__1
欧盟 拟 建立 允许 在 食品 添加剂 、 食品 酶制剂 、 食品 调味剂 和 营养 补充剂 中 使用 的 食品 添加剂 统一 目录	__label__0
日本 修订 有毒 有害物质 清单	__label__0
加拿大 有机 产品 法规 过渡性 政策 6 月 30 日 到期	__label__1
关于 发布 食品安全 国家标准 《 复配 食品 添加剂 通则 》 的 公告 （ 卫生部 公告 2011 年 第 18 号 ）	__label__1
英国 就 食品包装 正面 的 标识 规定 征求意见	__label__0
欧盟委员会 批准 葡聚糖 用于 啤酒	__label__0
欧盟 拟 修订 “ 欧盟 - 美国 葡萄酒 贸易 协议 ”	__label__0
勾兑 “ 配制 食醋 ” 自称 “ 酿造 食醋 ”   业内 称 标准 存 缺陷	__label__0
欧盟 修订 食品 接触 类 塑料 材料 法规	__label__0
俄罗斯 发布 酒精 饮料 “ 特殊 印花税 ” 版式 图	__label__1
美国 有意 制定 苯线 磷 的 限量 要求	__label__0
美国 制定 吡 噻菌胺 在 多种产品 中 的 限量 要求	__label__0
日本 发布 有机 加工 食品 农业 标准 修正案 综述 草案	__label__0
欧盟 食品 安全局 就 食品 与 饲料 中 T - 2 与 HT - 2 毒素 对人畜 的 健康 风险 发布 科学 意见	__label__0
多米尼加 修订 啤酒 标准	__label__0
《 食品安全 国家标准   不锈钢 制品 》 （ GB9684 - 2011 ） 发布	__label__1
印度 拟 建立 类 REACH 法律 体系	__label__0
欧洲 食品 安全局 认为 葡萄酒 中卵 清 蛋白 可 产生 不良 过敏反应	__label__0
日本 修订 加工 食品 中 黄曲霉 毒素 的 检查 方法	__label__0
国家 食品安全 风险 评估 中心 在 京 成立	__label__0
新西兰 食品 安全局 对 果酒 、 苹果酒 和 梨酒 的 实施 规章 草案 进行 讨论	__label__0
广东省 质监局 发布 2012 年 配制 酒 等 23 类食品 生产 环节 专项 抽检 情况通报	__label__1
欧盟 拟 修改 多种 商品 中啶 虫 咪 （ acetamiprid ） 的 现行 最高 残留 限量	__label__0
美国 延长 （ TTB ） No .   109 号 通告 征求意见 期	__label__0
新加坡 修订 食品 中 真菌 毒素 限量 要求	__label__0
欧盟 修订 “ gin （ 金酒 ） ” 技术 要求 ， 增加 “ Absinth （ 苦艾 酒 ） ” 及其 定义	__label__0
中国食品工业协会 马勇 ： 一般 食品 检测 方法 检测 白酒 塑化剂 不 科学	__label__1
国家 再次 公布 151 种 食品 和 饲料 中 非法 添加 名单	__label__1
质检 总局 批准 对纳帕 河谷 （ 葡萄酒 ） 实施 地理 标志 产品 保护	__label__0
英国 标准 协会 推出 了 关于 食品包装 的 新 标准 PAS - 223	__label__1
美国 TTB 公布 2010 年度 葡萄酒 抽样调查 结果	__label__1
欧盟 拟 修订 甲基 嘧啶 磷 在 多种 作物 中 的 最大 残留 限量	__label__0
商务部 发布 商务 领域 标准化 管理 办法 （ 试行 ）	__label__1
韩国 修订 食品 添加剂 使用 标准	__label__0
日本 将 规定 食品 中 放射性 铯 含量 不得 超过 1 毫希沃特	__label__0
德国 再 提名 3 个 REACH 法规 高 关注度 物质	__label__0
吉尔吉斯斯坦 发布 啤酒 生产 安全 技术 条例 草案	__label__1
欧盟 食品业 要求 欧洲委员会 批准 进口 含有 痕量 转基因 成分 的 食品	__label__1
质检 总局 网站 公布 了 2012 年 01 月 进境 不 合格 食品 、 化妆品 信息	__label__1
质检 总局 公布 2011 年 17 类 产品质量 国家 监督 抽查 结果	__label__1
韩国 修订 食品标签 标准	__label__0
澳大利亚 对 食品包装 材料 的 化学物质 迁移 进行 调查	__label__0
中国 酿酒 工业协会 第四届 理事会 第五次 （ 扩大 ） 会议 将 于   4 月 25 日 ～ 26 日 在 北京 召开	__label__0
韩国 拟 简化 食品安全 风险 评估 程序	__label__0
美国 拟将 蒸馏 酒 “ Cachaca ” 作为 一种 巴西 特产 的 朗姆酒 进行 管理	__label__0
澳新 食品 标准局 就 修订 多菌灵 、 乐果 等 农 兽药 的 最大 残留 限量 征求意见	__label__0
卫生部 公开 征求 富马酸 一钠 等 5 个 指定 食品 添加剂 标准 意见	__label__0
欧盟 出台 新 版本 的 塑料 类食品 接触 材料 中 化学物质 迁移 的 计算方法	__label__0
各国 有关 食品包装 材料 塑化剂 迁移 造成 食品 污染 的 现状及 法规 要求 进展	__label__1
5 项 包装 行业标准 经 复审 继续 有效	__label__0
浙江省工商局 公布 食品 监管 信息	__label__1
日本 酒 获准 有 限制 地 出口 中国	__label__0
欧盟 REACH 法规 再添 需 授权 物质 清单	__label__0
巴西 更新 食品 接触 材料 测试 标准	__label__0
欧盟 修改 食品 中 重金属 和 二恶英 等 污染物 的 最大 残留 限量	__label__0
英国 就 调查 本国 食品 中 重金属 的 污染 状况 征集 研究	__label__0
日本 发布 有机 饮料 酒 标签 标准 修正 提案	__label__1
卫生部 发布 关于 调整 国产 反渗透 净水器 和 国产 纳滤 净水器 卫生 行政许可 的 通知	__label__1
欧盟 拟 修订 大米 中丙环唑 的 最大 残留 限量	__label__0
酿酒 工业协会 发布 稳定 白酒 价格 的 倡议书	__label__1
加拿大 酿酒 协会 （ brewers   association   of   Canada ） 发布 “ 酿造 工业 能源 效率 指南 ”	__label__1
古越 龙山 黄酒 被 指含 致癌物 氨基 甲酸 乙酯	__label__1
质检 总局 将 从 6 月 1 日起 实施 《 进出口 预 包装 食品标签 检验 监督管理 规定 》	__label__1
欧盟 制定 与 食品 接触性 塑料 材料 与 物质 的 委员会 条例 草案	__label__0
欧盟 拟 修订 多种 植物 产品 中咯菌 腈 、 嘧菌胺 的 最高 残留 限量	__label__0
卫生部 办公厅 关于 征求 《 食品 中苯 并 （ a ） 芘 的 测定 》 等 11 项 食品安全 国家标准 （ 征求意见 稿 ） 意见 的 函	__label__0
日本 厚生 劳动 省 公布 2011 年度 进口 食品 监视 指导 计划	__label__1
欧盟 食品 安全局 修订 “ 日落黄 作为 食品 添加剂 的 最大 允许 水平 的 暴露 评估 数据 ”	__label__0
肯尼亚 发布 工业 酒精 法规 相关 通告	__label__1
美国 俄勒冈州 环境 参议院 通过 婴儿 奶瓶 双酚 A 禁令	__label__0
英国 食品 标准局 更新 甜菊糖 甙 应用 信息	__label__0
卫生部 关于 制定 D - 甘露 糖醇 等 58 个 食品 添加剂 产品 标准 的 公告	__label__1
卫生部 发布 关于 批准 焦磷酸 一氢三钠 等 5 种 食品 添加剂 新品种 的 公告	__label__1
11 月份 美国 农药 残留 限量 修订 情况 汇总	__label__0
澳大利亚 酿酒师 联合会 和 巴斯夫 公司 先后 向 澳新 食品 标准 管理局 申请 允许 将 羧甲基 纤维素 ( CMC ) 作为 稳定剂 在 葡萄酒 中 使用	__label__0
欧盟 就 N - （ 2 - 氨基 乙基 ） 乙醇胺 用于 食品 接触 材料 发布 了 安全性 评估 报告	__label__0
国务院 法制 办公室 对 《 粮食 法 （ 征求意见 稿 ） 》 公开 征求意见	__label__0
韩国 修改 食品 标准规范 中 多种 农残 限量 要求	__label__0
欧盟 公布 未来 三年 对 动植物 源 食品 中 农药 残留 监控 的 物质 名单	__label__1
卫生部 公开 征求 亚 硫酸钾 等 22 个 指定 食品 添加剂 标准 意见	__label__0
1 月份 中国 出口 至 韩国 的 食品 违规 情况	__label__1
欧盟 更新 食品 进口 列表	__label__1
欧盟 批准 酿酒 酵母 作为 育肥 兔 以及 非 食用 兔 饲料 添加剂	__label__0
澳大利亚 修订 氟甲 吡啶 氧酚 丙酸 丁酯 、 苯 敌草 等 9 种 农药 的 残留 限量	__label__0
台湾地区 发布 食品 器具 容器 包装 卫生标准 修正案	__label__1
欧盟委员会 批准 苯甲酸 盐 用于 无醇 葡萄酒	__label__0
欧盟 研究者 得出结论 认为 BPS 表现 出 和 BPA 较为 相似 的 激素 活性	__label__0
国家 食品安全 风险 评估 中心 将 承担 食品安全 国家标准 审评 委员会 秘书处 工作	__label__0
欧盟 更新 了 可 用于 食品 接触性 塑料 材料 的 添加剂 临时 清单	__label__0
卫生部 关于 亚 硝酸钾 等 27 个 食品 添加剂 产品 标准 的 公告 （ 卫生部 公告 2011 年 第 19 号 ）	__label__1
欧美 统一 有机 食品 贸易 认证 体系	__label__0
日本 修订 灭螨醌 等 7 种 农药 在 食品 中 的 残留 限量 标准	__label__0
澳新 就 即食 食品 中 李斯特 菌 的 最新 限量 标准 征求意见	__label__0
美国 FDA 新 措施 落实 执行 食品安全 现代化 法 各项 条文	__label__1
欧盟 修改 食品 中 二氯 吡啶 酸 等 5 种 农药 的 最大 残留 限量	__label__0
卫生部 发布 食品安全 国家标准 管理 办法	__label__1
欧盟 就 食品 与 饲料 中 的 桔 霉素 对人畜 健康 的 影响 发布 科学 意见	__label__0
山西 质检局 发布 白酒 等 食品质量 监督 抽查 结果	__label__1
加拿大 卫生部 表示 软饮料 和 啤酒 产品 暴露 的 双酚 A 极低	__label__0
国际 食品包装 协会 发布 “ 食品包装 产品质量 情况 调查 ” 报告	__label__0
韩国 酒类 制品 将 标明 原料 产地	__label__0
日本 拟 批准 2 , 6 - 二甲基 吡啶 等 作为 食品 添加剂 使用	__label__0
加拿大 发布 数项 农药 最大 残留 限量 修订案	__label__1
美国 免除 农药 巴斯德 菌 属   （ Rotylenchulus   reniformis   nematode ） - Pr3 的 残留 限量 要求	__label__1
欧盟 拟 修订 四聚 乙醛 在 5 种 作物 中 的 最大 残留 限量	__label__0
美国 TTB 公告 称 将 改变 有机 酒精 饮料 认证 文件 要求	__label__0
中国台湾 制定 天然 食用 色素 卫生标准 草案	__label__1
澳大利亚 将 甲醛 的 致癌 分类 从 3 级 升至 2 级	__label__1
日本 厚生 劳动 省 正式 确定 食品 中 放射性 铯 新 标准值	__label__0
欧盟 修订 EuropeanParliamentandCouncilDirective95 / 2 / EC 食品 添加剂 （ 不 含 着色剂 和 甜味剂 ） 法规	__label__0
欧盟 正式 公布 第六批 20 种高 关注度 物质 清单	__label__1
卫生部 拟 批准 1 , 3 : 2 , 4 - 双 - 氧 - （ 对 氯苯 亚 甲基 ） - D - 山梨糖 醇 等 食品 包材用 添加剂	__label__0
国家 质检 总局 发布 《 关于 进一步 加强 进口 台湾 食品 、 食品 添加剂 及 相关 产品检验 监管 的 公告 》 （ 2011 年 第 79 号 公告 ）	__label__1
环保部 发布 《 综合类 生态 工业园区 标准 》 （ HJ274 - 2009 ） 修改 方案	__label__1
卫生部 发布 食品安全 国家标准 《 粮食 》 征求意见 稿	__label__0
湖南 质监局 ， 酒鬼 酒 DBP 最高 检出 值为 1.04 mg / kg	__label__1
阿根廷 对 葡萄酒 中纳 他 霉素 问题 进一步 加强 管理	__label__0
欧洲 食品 安全局 认为 葡萄酒 中 溶菌酶 可 产生 不良 过敏反应	__label__0
AQ   4222 - 2012 《 酒类 生产 企业 防尘 防毒 技术 要求 》 于 9 月 1 日 正式 实施	__label__1
卫生部 发布 GB28050 - 2011 《 预 包装 食品 营养 标签 通则 》	__label__1
加拿大 拟定 叶菌 唑 最大 残留 限量	__label__0
美韩 互认 四个 蒸馏 酒 地理 标志 产品	__label__0
欧盟 拟 修订 几种 核果 中克菌丹 的 最大 残留 限量	__label__0
环保部 发布 《 葡萄酒 、 黄酒 工业 水污染 物排放 标准 》 征求意见 稿	__label__0
北京市 食品 安全监控 中心 宣称 攻克 “ 地沟油 ” 检测 难关	__label__0
工信部 发布 《 葡萄酒 行业 准入条件 》	__label__1
欧盟 拟 修订 多种 作物 中 农药 乐果 的 现行 MRL 值	__label__0
欧盟 食品 安全局 确认 焦糖 色素 的 食用 安全性	__label__0
欧盟 完成 对 食品 色素 的 重新 评估	__label__0
香港 《 食物 安全 条例 》 于 2012 年 2 月 1 日 全面 生效	__label__1
关于 速报 食品 添加剂 产品 指定 标准 相关 资料 的 通知	__label__0
国家标准 委 关于 批准 发布 GB / T   19961 - 2005 《 地理 标志 产品   剑南春 酒 》 第 1 号 修改 单 的 公告	__label__1
卫生部 批准 焦 糖色 （ 苛性 硫酸盐 法 ） 用于 威士忌酒 生产	__label__0
质检 总局 发布 关于 参茸 酒 等 产品 不 作为 普通 食品 管理 的 通知	__label__1
欧盟 严格 限定 含铝 食品 添加剂 的 使用 条件 及 限量	__label__0
